***Anti-Pattern*** 
Count: 23
/accept-certificate-transfer/certificateId?setAsActive=setAsActive	Non-hierarchical Nodes	Reversed hierarchy of type True detected between accept and certificate. 0 hierarchical relations were detected out of 4
/thing-groups/addThingToThingGroup	Non-hierarchical Nodes	Reversed hierarchy of type True detected between thing and groups. 0 hierarchical relations were detected out of 5
/audit/mitigationactions/tasks/taskId/cancel	Non-hierarchical Nodes	Reversed hierarchy of type True detected between mitigation and actions. 0 hierarchical relations were detected out of 6
/dynamic-thing-groups/thingGroupName	Non-hierarchical Nodes	Reversed hierarchy of type True detected between thing and groups. 0 hierarchical relations were detected out of 5
/billing-groups/billingGroupName	Non-hierarchical Nodes	Reversed hierarchy of type True detected between group and name. 0 hierarchical relations were detected out of 4
/thing-groups/thingGroupName	Non-hierarchical Nodes	Reversed hierarchy of type True detected between thing and groups. 0 hierarchical relations were detected out of 4
/thing-groups/updateThingGroupsForThing	Non-hierarchical Nodes	Reversed hierarchy of type True detected between thing and groups. 0 hierarchical relations were detected out of 5
/transfer-certificate/certificateId?targetAwsAccount=targetAwsAccount	Non-hierarchical Nodes	Reversed hierarchy of type True detected between transfer and certificate. 0 hierarchical relations were detected out of 3
/audit/mitigationactions/tasks/taskId	Non-hierarchical Nodes	Reversed hierarchy of type True detected between mitigation and actions. 0 hierarchical relations were detected out of 5
/thing-groups/removeThingFromThingGroup	Non-hierarchical Nodes	Reversed hierarchy of type True detected between thing and groups. 0 hierarchical relations were detected out of 5
/violation-events?endTime=endTime&maxResults=maxResults&nextToken=nextToken&securityProfileName=securityProfileName&startTime=startTime&thingName=thingName	Non-hierarchical Nodes	Reversed hierarchy of type True detected between violation and events. 0 hierarchical relations were detected out of 1
/thing-groups/thingGroupName/things?maxResults=maxResults&nextToken=nextToken&recursive=recursive	Non-hierarchical Nodes	Reversed hierarchy of type True detected between thing and groups. 0 hierarchical relations were detected out of 5
/billing-groups/billingGroupName/things?maxResults=maxResults&nextToken=nextToken	Non-hierarchical Nodes	Reversed hierarchy of type True detected between group and name. 0 hierarchical relations were detected out of 5
/things/thingName/thing-groups?maxResults=maxResults&nextToken=nextToken	Non-hierarchical Nodes	Reversed hierarchy of type True detected between thing and groups. 0 hierarchical relations were detected out of 4
/thing-groups?maxResults=maxResults&namePrefixFilter=namePrefixFilter&nextToken=nextToken&parentGroup=parentGroup&recursive=recursive	Non-hierarchical Nodes	Reversed hierarchy of type True detected between thing and groups. 0 hierarchical relations were detected out of 1
/mitigationactions/actions?actionType=actionType&maxResults=maxResults&nextToken=nextToken	Non-hierarchical Nodes	Reversed hierarchy of type True detected between mitigation and actions. 0 hierarchical relations were detected out of 2
/thing-groups/thingGroupName	Non-hierarchical Nodes	Reversed hierarchy of type True detected between thing and groups. 0 hierarchical relations were detected out of 4
/audit/mitigationactions/tasks/taskId	Non-hierarchical Nodes	Reversed hierarchy of type True detected between mitigation and actions. 0 hierarchical relations were detected out of 5
/audit/findings/findingId	Non-hierarchical Nodes	Reversed hierarchy of type True detected between finding and identification. 0 hierarchical relations were detected out of 3
/mitigationactions/actions/actionName	Non-hierarchical Nodes	Reversed hierarchy of type True detected between mitigation and actions. 0 hierarchical relations were detected out of 4
/dynamic-thing-groups/thingGroupName	Non-hierarchical Nodes	Reversed hierarchy of type True detected between thing and groups. 0 hierarchical relations were detected out of 5
/billing-groups/billingGroupName	Non-hierarchical Nodes	Reversed hierarchy of type True detected between group and name. 0 hierarchical relations were detected out of 4
/cancel-certificate-transfer/certificateId	Non-hierarchical Nodes	Reversed hierarchy of type True detected between certificate and transfer. 0 hierarchical relations were detected out of 4

***Patterns*** 
Count: 127
/billing-groups/addThingToBillingGroup	Hierarchical Nodes	
/jobs/jobId/targets?namespaceId=namespaceId	Hierarchical Nodes	
/target-policies/policyName	Hierarchical Nodes	
/principal-policies/policyName	Hierarchical Nodes	
/security-profiles/securityProfileName/targets?securityProfileTargetArn=securityProfileTargetArn	Hierarchical Nodes	
/things/thingName/principals	Hierarchical Nodes	
/audit/tasks/taskId/cancel	Hierarchical Nodes	
/jobs/jobId?namespaceId=namespaceId	Hierarchical Nodes	
/indexing/config	Hierarchical Nodes	
/domainConfigurations/domainConfigurationName	Hierarchical Nodes	
/dimensions/name	Hierarchical Nodes	
/certificates/certificateId?newStatus=newStatus	Hierarchical Nodes	
/authorizer/authorizerName	Hierarchical Nodes	
/audit/suppressions/update	Hierarchical Nodes	
/audit/configuration	Hierarchical Nodes	
/provisioning-templates/templateName	Hierarchical Nodes	
/role-aliases/roleAlias	Hierarchical Nodes	
/audit/scheduledaudits/scheduledAuditName	Hierarchical Nodes	
/security-profiles/securityProfileName?expectedVersion=expectedVersion	Hierarchical Nodes	
/streams/streamId	Hierarchical Nodes	
/things/thingName	Hierarchical Nodes	
/destinations	Hierarchical Nodes	
/security-profile-behaviors/validate	Hierarchical Nodes	
/authorizer/authorizerName/test	Hierarchical Nodes	
/test-authorization?clientId=clientId	Hierarchical Nodes	
/tags	Hierarchical Nodes	
/thing-registration-tasks	Hierarchical Nodes	
/audit/tasks	Hierarchical Nodes	
/loggingOptions	Hierarchical Nodes	
/policies/policyName/version/policyVersionId	Hierarchical Nodes	
/default-authorizer	Hierarchical Nodes	
/indices/search	Hierarchical Nodes	
/rules/ruleName	Hierarchical Nodes	
/cacertificate?allowAutoRegistration=allowAutoRegistration&setAsActive=setAsActive	Hierarchical Nodes	
/v2LoggingLevel?maxResults=maxResults&nextToken=nextToken&targetType=targetType	Hierarchical Nodes	
/rules?maxResults=maxResults&nextToken=nextToken&ruleDisabled=ruleDisabled&topic=topic	Hierarchical Nodes	
/destinations?maxResults=maxResults&nextToken=nextToken	Hierarchical Nodes	
/thing-types?maxResults=maxResults&nextToken=nextToken&thingTypeName=thingTypeName	Hierarchical Nodes	
/things?attributeName=attributeName&attributeValue=attributeValue&maxResults=maxResults&nextToken=nextToken&thingTypeName=thingTypeName	Hierarchical Nodes	
/thing-registration-tasks?maxResults=maxResults&nextToken=nextToken&status=status	Hierarchical Nodes	
/thing-registration-tasks/taskId/reports?maxResults=maxResults&nextToken=nextToken&reportType=reportType	Hierarchical Nodes	
/things/thingName/principals?maxResults=maxResults&nextToken=nextToken	Hierarchical Nodes	
/security-profiles/securityProfileName/targets?maxResults=maxResults&nextToken=nextToken	Hierarchical Nodes	
/policy-targets/policyName?marker=marker&pageSize=pageSize	Hierarchical Nodes	
/tags?nextToken=nextToken&resourceArn=resourceArn	Hierarchical Nodes	
/streams?isAscendingOrder=ascendingOrder&maxResults=maxResults&nextToken=nextToken	Hierarchical Nodes	
/security-profiles-for-target?maxResults=maxResults&nextToken=nextToken&recursive=recursive&securityProfileTargetArn=securityProfileTargetArn	Hierarchical Nodes	
/security-profiles?dimensionName=dimensionName&maxResults=maxResults&nextToken=nextToken	Hierarchical Nodes	
/audit/scheduledaudits?maxResults=maxResults&nextToken=nextToken	Hierarchical Nodes	
/role-aliases?isAscendingOrder=ascendingOrder&marker=marker&pageSize=pageSize	Hierarchical Nodes	
/provisioning-templates/templateName/versions?maxResults=maxResults&nextToken=nextToken	Hierarchical Nodes	
/provisioning-templates?maxResults=maxResults&nextToken=nextToken	Hierarchical Nodes	
/principals/things?maxResults=maxResults&nextToken=nextToken	Hierarchical Nodes	
/principal-policies?isAscendingOrder=ascendingOrder&marker=marker&pageSize=pageSize	Hierarchical Nodes	
/policies/policyName/version	Hierarchical Nodes	
/policy-principals?isAscendingOrder=ascendingOrder&marker=marker&pageSize=pageSize	Hierarchical Nodes	
/certificates-out-going?isAscendingOrder=ascendingOrder&marker=marker&pageSize=pageSize	Hierarchical Nodes	
/policies?isAscendingOrder=ascendingOrder&marker=marker&pageSize=pageSize	Hierarchical Nodes	
/jobs?maxResults=maxResults&namespaceId=namespaceId&nextToken=nextToken&status=status&targetSelection=targetSelection&thingGroupId=thingGroupId&thingGroupName=thingGroupName	Hierarchical Nodes	
/things/thingName/jobs?maxResults=maxResults&namespaceId=namespaceId&nextToken=nextToken&status=status	Hierarchical Nodes	
/jobs/jobId/things?maxResults=maxResults&nextToken=nextToken&status=status	Hierarchical Nodes	
/indices?maxResults=maxResults&nextToken=nextToken	Hierarchical Nodes	
/domainConfigurations?marker=marker&pageSize=pageSize&serviceType=serviceType	Hierarchical Nodes	
/dimensions?maxResults=maxResults&nextToken=nextToken	Hierarchical Nodes	
/certificates-by-ca/caCertificateId?isAscendingOrder=ascendingOrder&marker=marker&pageSize=pageSize	Hierarchical Nodes	
/certificates?isAscendingOrder=ascendingOrder&marker=marker&pageSize=pageSize	Hierarchical Nodes	
/cacertificates?isAscendingOrder=ascendingOrder&marker=marker&pageSize=pageSize	Hierarchical Nodes	
/billing-groups?maxResults=maxResults&namePrefixFilter=namePrefixFilter&nextToken=nextToken	Hierarchical Nodes	
/authorizers/?isAscendingOrder=ascendingOrder&marker=marker&pageSize=pageSize&status=status	Hierarchical Nodes	
/audit/tasks?endTime=endTime&maxResults=maxResults&nextToken=nextToken&startTime=startTime&taskStatus=taskStatus&taskType=taskType	Hierarchical Nodes	
/audit/suppressions/list	Hierarchical Nodes	
/audit/findings	Hierarchical Nodes	
/active-violations?maxResults=maxResults&nextToken=nextToken&securityProfileName=securityProfileName&thingName=thingName	Hierarchical Nodes	
/v2LoggingOptions	Hierarchical Nodes	
/rules/ruleName	Hierarchical Nodes	
/indices/statistics	Hierarchical Nodes	
/policies/policyName/version/policyVersionId	Hierarchical Nodes	
/policies/policyName	Hierarchical Nodes	
/indices/percentiles	Hierarchical Nodes	
/loggingOptions	Hierarchical Nodes	
/jobs/jobId/job-document	Hierarchical Nodes	
/indexing/config	Hierarchical Nodes	
/effective-policies?thingName=thingName	Hierarchical Nodes	
/indices/cardinality	Hierarchical Nodes	
/rules/ruleName/enable	Hierarchical Nodes	
/rules/ruleName/disable	Hierarchical Nodes	
/things/thingName/principals	Hierarchical Nodes	
/security-profiles/securityProfileName/targets?securityProfileTargetArn=securityProfileTargetArn	Hierarchical Nodes	
/target-policies/policyName	Hierarchical Nodes	
/thing-types/thingTypeName	Hierarchical Nodes	
/thing-registration-tasks/taskId	Hierarchical Nodes	
/security-profiles/securityProfileName	Hierarchical Nodes	
/role-aliases/roleAlias	Hierarchical Nodes	
/provisioning-templates/templateName/versions/versionId	Hierarchical Nodes	
/provisioning-templates/templateName	Hierarchical Nodes	
/event-configurations	Hierarchical Nodes	
/endpoint?endpointType=endpointType	Hierarchical Nodes	
/domainConfigurations/domainConfigurationName	Hierarchical Nodes	
/default-authorizer	Hierarchical Nodes	
/audit/tasks/taskId	Hierarchical Nodes	
/audit/suppressions/describe	Hierarchical Nodes	
/audit/configuration	Hierarchical Nodes	
/thing-types/thingTypeName	Hierarchical Nodes	
/things/thingName?expectedVersion=expectedVersion	Hierarchical Nodes	
/provisioning-templates/templateName/versions/versionId	Hierarchical Nodes	
/provisioning-templates/templateName	Hierarchical Nodes	
/policies/policyName/version/policyVersionId	Hierarchical Nodes	
/policies/policyName	Hierarchical Nodes	
/jobs/jobId?force=force&namespaceId=namespaceId	Hierarchical Nodes	
/certificates/certificateId?forceDelete=forceDelete	Hierarchical Nodes	
/audit/suppressions/delete	Hierarchical Nodes	
/audit/configuration?deleteScheduledAudits=deleteScheduledAudits	Hierarchical Nodes	
/destinations	Hierarchical Nodes	
/rules/ruleName	Hierarchical Nodes	
/things/thingName	Hierarchical Nodes	
/streams/streamId	Hierarchical Nodes	
/provisioning-templates/templateName/versions?setAsDefault=setAsDefault	Hierarchical Nodes	
/policies/policyName/version?setAsDefault=setAsDefault	Hierarchical Nodes	
/policies/policyName	Hierarchical Nodes	
/keys-and-certificate?setAsActive=setAsActive	Hierarchical Nodes	
/dimensions/name	Hierarchical Nodes	
/certificates?setAsActive=setAsActive	Hierarchical Nodes	
/audit/suppressions/create	Hierarchical Nodes	
/confirmdestination/confirmationToken+	Hierarchical Nodes	
/default-authorizer	Hierarchical Nodes	
/things/thingName/jobs/jobId/cancel?force=force	Hierarchical Nodes	
/jobs/jobId/cancel?force=force	Hierarchical Nodes	
