***Anti-Pattern*** 
Count: 12
-/appPricePoints	Non-pertinent Documentation	filter by id(s) of related priceTier
-/appPriceTiers	Non-pertinent Documentation	filter by id(s)
-/appPriceTiers/{id}	Non-pertinent Documentation	the fields to include for returned resources of type appPriceTiers
-/apps	Non-pertinent Documentation	filter by attribute 'appStoreVersions.appStoreState
-/betaAppLocalizations	Non-pertinent Documentation	filter by attribute locale
-/endUserLicenseAgreements/{id}	Non-pertinent Documentation	the fields to include for returned resources of type endUserLicenseAgreements
-/financeReports	Non-pertinent Documentation	filter by attribute regionCode
-/preReleaseVersions	Non-pertinent Documentation	filter by attribute builds.expired
-/salesReports	Non-pertinent Documentation	filter by attribute frequency
-/appCategories/{id}/subcategories	Non-pertinent Documentation	the fields to include for returned resources of type appCategories
-/appInfos/{id}/ageRatingDeclaration	Non-pertinent Documentation	the fields to include for returned resources of type ageRatingDeclarations
-/appInfos/{id}/appInfoLocalizations	Non-pertinent Documentation	filter by attribute locale

***Patterns*** 
Count: 20
-/appCategories	Pertinent Documentation	filter by attribute platforms
-/appCategories/{id}	Pertinent Documentation	the fields to include for returned resources of type appCategories
-/appEncryptionDeclarations	Pertinent Documentation	filter by attribute platform
-/appEncryptionDeclarations/{id}	Pertinent Documentation	the fields to include for returned resources of type appEncryptionDeclarations
-/appInfoLocalizations/{id}	Pertinent Documentation	the fields to include for returned resources of type appInfoLocalizations
-/appInfos/{id}	Pertinent Documentation	the fields to include for returned resources of type appInfos
-/appPreOrders/{id}	Pertinent Documentation	the fields to include for returned resources of type appPreOrders
-/appPreviewSets/{id}	Pertinent Documentation	the fields to include for returned resources of type appPreviews
-/appPreviews/{id}	Pertinent Documentation	the fields to include for returned resources of type appPreviews
-/appPricePoints/{id}	Pertinent Documentation	the fields to include for returned resources of type appPricePoints
-/appPrices/{id}	Pertinent Documentation	the fields to include for returned resources of type appPrices
-/appScreenshotSets/{id}	Pertinent Documentation	the fields to include for returned resources of type appScreenshotSets
-/appScreenshots/{id}	Pertinent Documentation	the fields to include for returned resources of type appScreenshots
-/appStoreReviewAttachments/{id}	Pertinent Documentation	the fields to include for returned resources of type appStoreReviewAttachments
-/appStoreReviewDetails/{id}	Pertinent Documentation	he fields to include for returned resources of type appStoreReviewDetails
-/appStoreVersionLocalizations/{id}	Pertinent Documentation	the fields to include for returned resources of type appStoreVersionLocalizations
-/appStoreVersions/{id}	Pertinent Documentation	the fields to include for returned resources of type appStoreVersions
-/routingAppCoverages/{id}	Pertinent Documentation	the fields to include for returned resources of type routingAppCoverages
-/appEncryptionDeclarations/{id}/app	Pertinent Documentation	the fields to include for returned resources of type apps
-/appInfos/{id}/primaryCategory	Pertinent Documentation	the fields to include for returned resources of type appCategories
