***Anti-Pattern*** 
Count: 8
/bui/getBUIAllConfig	Amorphous End-point	 [uppercase found] 
/bui/getBopSID	Amorphous End-point	 [uppercase found] 
/bui/getKDAttachments({id})	Amorphous End-point	 [uppercase found] 
/bui/getKDComments({id})	Amorphous End-point	 [uppercase found] 
/bui/addKDComment({id})	Amorphous End-point	 [uppercase found] 
/bui/getEEMAuth	Amorphous End-point	 [uppercase found] 
/gs/mytkt_active	Amorphous End-point	 [underscore found] 
/gs/mytkt_inactive	Amorphous End-point	 [underscore found] 

***Patterns*** 
Count: 32
/api/getAccess	Tidy End-point	Tidy Endpoint
/bui/getAllowedStatus	Tidy End-point	Tidy Endpoint
/bui/getMyTicketDetails({persid})	Tidy End-point	Tidy Endpoint
/bui/getTicketsCustomData({persid})	Tidy End-point	Tidy Endpoint
/bui/getDefaultCategories	Tidy End-point	Tidy Endpoint
/bui/attrInfo	Tidy End-point	Tidy Endpoint
/bui/attrCtrl	Tidy End-point	Tidy Endpoint
/bui/addLogComment	Tidy End-point	Tidy Endpoint
/bui/changeStatus/{factory}({persid})	Tidy End-point	Tidy Endpoint
/bui/allFeeds({persid})	Tidy End-point	Tidy Endpoint
/bui/attmnt	Tidy End-point	Tidy Endpoint
/bui/attmnt({persid})/$value	Tidy End-point	Tidy Endpoint
/bui/updateStatusForNotification	Tidy End-point	Tidy Endpoint
/bui/updateStatusForAllNotification	Tidy End-point	Tidy Endpoint
/bui/getMyResources	Tidy End-point	Tidy Endpoint
/bui/getMyActiveChatSession	Tidy End-point	Tidy Endpoint
/bui/checkActiveSessions	Tidy End-point	Tidy Endpoint
/bui/createChatThread	Tidy End-point	Tidy Endpoint
/bui/getChatHistory/{roomName}	Tidy End-point	Tidy Endpoint
/bui/getDocument({id})	Tidy End-point	Tidy Endpoint
/bui/rateDocument({id})	Tidy End-point	Tidy Endpoint
/bui/kdLinkInfo({id})	Tidy End-point	Tidy Endpoint
/bui/unLinkSolution({id})	Tidy End-point	Tidy Endpoint
/bui/helpAbout	Tidy End-point	Tidy Endpoint
/bui/{factory}({persid})	Tidy End-point	Tidy Endpoint
/bui/{factory}({persid})	Tidy End-point	Tidy Endpoint
/bui/{factory}	Tidy End-point	Tidy Endpoint
/bui/{factory}	Tidy End-point	Tidy Endpoint
/getServiceRequest	Tidy End-point	Tidy Endpoint
/pcatSearch	Tidy End-point	Tidy Endpoint
/getOfferings	Tidy End-point	Tidy Endpoint
/suggestedSolutions	Tidy End-point	Tidy Endpoint
