***Anti-Pattern*** 
Count: 4
/bui/getBopSID	 Contextless Resource Names
/bui/getChatHistory/{roomName}	 Contextless Resource Names
/pcatSearch	 Contextless Resource Names
/getOfferings	 Contextless Resource Names

***Patterns*** 
Count: 36
/api/getAccess	 Contextual Resource Names
/bui/getBUIAllConfig	 Contextual Resource Names
/bui/getAllowedStatus	 Contextual Resource Names
/bui/getMyTicketDetails({persid})	 Contextual Resource Names
/bui/getTicketsCustomData({persid})	 Contextual Resource Names
/bui/getDefaultCategories	 Contextual Resource Names
/bui/attrInfo	 Contextual Resource Names
/bui/attrCtrl	 Contextual Resource Names
/bui/addLogComment	 Contextual Resource Names
/bui/changeStatus/{factory}({persid})	 Contextual Resource Names
/bui/allFeeds({persid})	 Contextual Resource Names
/bui/attmnt	 Contextual Resource Names
/bui/attmnt({persid})/$value	 Contextual Resource Names
/bui/updateStatusForNotification	 Contextual Resource Names
/bui/updateStatusForAllNotification	 Contextual Resource Names
/bui/getMyResources	 Contextual Resource Names
/bui/getMyActiveChatSession	 Contextual Resource Names
/bui/checkActiveSessions	 Contextual Resource Names
/bui/createChatThread	 Contextual Resource Names
/bui/getDocument({id})	 Contextual Resource Names
/bui/getKDAttachments({id})	 Contextual Resource Names
/bui/getKDComments({id})	 Contextual Resource Names
/bui/addKDComment({id})	 Contextual Resource Names
/bui/rateDocument({id})	 Contextual Resource Names
/bui/kdLinkInfo({id})	 Contextual Resource Names
/bui/unLinkSolution({id})	 Contextual Resource Names
/bui/helpAbout	 Contextual Resource Names
/bui/getEEMAuth	 Contextual Resource Names
/bui/{factory}({persid})	 Contextual Resource Names
/bui/{factory}({persid})	 Contextual Resource Names
/bui/{factory}	 Contextual Resource Names
/bui/{factory}	 Contextual Resource Names
/gs/mytkt_active	 Contextual Resource Names
/gs/mytkt_inactive	 Contextual Resource Names
/getServiceRequest	 Contextual Resource Names
/suggestedSolutions	 Contextual Resource Names
