***Anti-Pattern*** 
Count: 28
/account/set_profile_photo 	 No Version Found
/auth/token/from_oauth1 	 No Version Found
/auth/token/revoke 	 No Version Found
/check/app 	 No Version Found
/check/user 	 No Version Found
/contacts/delete_manual_contacts 	 No Version Found
/contacts/delete_manual_contacts_batch 	 No Version Found
/file_properties/properties/add 	 No Version Found
/file_properties/properties/overwrite 	 No Version Found
/file_properties/properties/search/continue 	 No Version Found
/file_properties/templates/remove_for_user 	 No Version Found
/file_properties/templates/update_for_user 	 No Version Found
/file_properties/properties/update 	 No Version Found
/file_requests/count 	 No Version Found
/file_requests/create 	 No Version Found
/file_requests/delete 	 No Version Found
/file_requests/delete_all_closed 	 No Version Found
/file_requests/list/continue 	 No Version Found
/files/copy_reference/get 	 No Version Found
/files/copy_reference/save 	 No Version Found
/files/create_folder_batch 	 No Version Found
/files/create_folder_batch/check 	 No Version Found
/files/delete_batch/check 	 No Version Found
/files/download_zip 	 No Version Found
/files/get_file_lock_batch 	 No Version Found
/files/get_temporary_upload_link 	 No Version Found
/files/list_folder/get_latest_cursor 	 No Version Found
/files/save_url/check_job_status 	 No Version Found

***Patterns*** 
Count: 4
/files/copy_batch_v2 	 Version Found
/files/copy_batch/check_v2 	 Version Found
/files/move_batch/check_v2 	 Version Found
/files/upload_session/append_v2 	 Version Found
