***Anti-Pattern*** 
Count: 15
/{application-id}/aem_conversion_configs	Amorphous End-point	 [underscore found] 
/{application_id}/app_indexing	Amorphous End-point	 [underscore found] 
/{application-id}/app_installed_groups	Amorphous End-point	 [underscore found] 
/v11.0/{application-id}/authorized_adaccounts	Amorphous End-point	 [underscore found] 
/{application-id}/button_auto_detection_device_selection	Amorphous End-point	 [underscore found] 
/{application_id}/codeless_event_mappings	Amorphous End-point	 [underscore found] 
/{application_id}/leaderboards_reset	Amorphous End-point	 [underscore found] 
/{application_id}/page_activities	Amorphous End-point	 [underscore found] 
/{application_id}/payment_currencies	Amorphous End-point	 [underscore found] 
/{application_id}/user_properties	Amorphous End-point	 [underscore found] 
/{object-id}/private_replies	Amorphous End-point	 [underscore found] 
/{destination-id}/augmented_realities_metadata	Amorphous End-point	 [underscore found] 
/{destination-id}/videos_metadata	Amorphous End-point	 [underscore found] 
/{event_id}/live_videos	Amorphous End-point	 [underscore found] 
/debug_token	Amorphous End-point	 [underscore found] 

***Patterns*** 
Count: 50
/{album-id}/comments	Tidy End-point	Tidy Endpoint
/{album-id}/likes	Tidy End-point	Tidy Endpoint
/{album-id}/photos	Tidy End-point	Tidy Endpoint
/{album-id}/picture	Tidy End-point	Tidy Endpoint
/{application-id}/accounts	Tidy End-point	Tidy Endpoint
/{application_id}/activities	Tidy End-point	Tidy Endpoint
/{application-id}/appassets	Tidy End-point	Tidy Endpoint
/{application_id}/assets	Tidy End-point	Tidy Endpoint
/{application-id}/products	Tidy End-point	Tidy Endpoint
/{canvas-id}	Tidy End-point	Tidy Endpoint
/{page_id}/canvases	Tidy End-point	Tidy Endpoint
/{conversation-id}/messages	Tidy End-point	Tidy Endpoint
/{group-id}/admins	Tidy End-point	Tidy Endpoint
/{group-id}/albums	Tidy End-point	Tidy Endpoint
/{group-id}/docs	Tidy End-point	Tidy Endpoint
/{group-id}/events	Tidy End-point	Tidy Endpoint
/{group-id}/feed	Tidy End-point	Tidy Endpoint
/{user-id}/outbox	Tidy End-point	Tidy Endpoint
/{user-id}/scores	Tidy End-point	Tidy Endpoint
/{app-id}/achievements	Tidy End-point	Tidy Endpoint
/{app-id}/groups	Tidy End-point	Tidy Endpoint
/{object-id}/insights/{metric-name}	Tidy End-point	Tidy Endpoint
/{app-id}/picture	Tidy End-point	Tidy Endpoint
/{app-id}/roles	Tidy End-point	Tidy Endpoint
/{app-id}/scores	Tidy End-point	Tidy Endpoint
/{app-id}/staticresources	Tidy End-point	Tidy Endpoint
/{app-id}/subscriptions	Tidy End-point	Tidy Endpoint
/{app-id}/translations	Tidy End-point	Tidy Endpoint
/app-link-host	Tidy End-point	Tidy Endpoint
/{conversation-id}/messages	Tidy End-point	Tidy Endpoint
/{event-id}/feed	Tidy End-point	Tidy Endpoint
/{group-id}/admins	Tidy End-point	Tidy Endpoint
/{group-id}/albums	Tidy End-point	Tidy Endpoint
/{group-id}/events	Tidy End-point	Tidy Endpoint
/{group-id}/feed	Tidy End-point	Tidy Endpoint
/{group-id}/files	Tidy End-point	Tidy Endpoint
/{group-id}/members	Tidy End-point	Tidy Endpoint
/{object-id}/insights/{metric-name}	Tidy End-point	Tidy Endpoint
/{object-id}/likes	Tidy End-point	Tidy Endpoint
/{milestone-id}/photos	Tidy End-point	Tidy Endpoint
/{object-id}/comments	Tidy End-point	Tidy Endpoint
/{page-id}/conversations	Tidy End-point	Tidy Endpoint
/{page-id}/feed	Tidy End-point	Tidy Endpoint
/{page-id}/locations	Tidy End-point	Tidy Endpoint
/{page-id}/notifications	Tidy End-point	Tidy Endpoint
/{payment-id}/dispute	Tidy End-point	Tidy Endpoint
/{payment-id}/refunds	Tidy End-point	Tidy Endpoint
/{object-id}/sharedposts	Tidy End-point	Tidy Endpoint
/{user-id}/feed	Tidy End-point	Tidy Endpoint
/{user-id}/friends	Tidy End-point	Tidy Endpoint
