***Anti-Pattern*** 
Count: 7
/{ig-comment-id}?fields={fields}	Non-standard End-point	 [unknown char found] 
/{ig-comment-id}?hide={hide}	Non-standard End-point	 [unknown char found] 
/{ig-media-id}?fields={fields}	Non-standard End-point	 [unknown char found] 
/{ig-media-id}?comment_enabled={comment_enabled}	Non-standard End-point	 [unknown char found] 
/{ig-media-id}/comments?message={message}	Non-standard End-point	 [unknown char found] 
/{ig-user-id}?fields={fields}	Non-standard End-point	 [unknown char found] 
/{page-id}?fields=instagram_business_account	Non-standard End-point	 [unknown char found] 

***Patterns*** 
Count: 14
/{ig-comment-id}	Standard End-point	
/oauth/authorize	Standard End-point	
/oauth/access_token	Standard End-point	
/access_token	Standard End-point	
/refresh_access_token	Standard End-point	
/oauth/authorize	Standard End-point	
/{media-id}	Standard End-point	
/{media-id}/children	Standard End-point	
/{user-id}/media	Standard End-point	
/me	Standard End-point	
/{user-id}	Standard End-point	
/{user-id}/media	Standard End-point	
/{ig-hashtag-id}	Standard End-point	
/{ig-media-id}/comments	Standard End-point	
