***Anti-Pattern*** 
Count: 7
/admin/capacities/AssignWorkspaces	Amorphous End-point	 [uppercase found] 
/admin/capacities/UnassignWorkspaces	Amorphous End-point	 [uppercase found] 
/admin/tenantKeys/{tenantKeyId}/Default.Rotate	Amorphous End-point	 [uppercase found]  [uppercase found] 
/capacities/{capacityId}/Workloads/{workloadName}	Amorphous End-point	 [uppercase found] 
/capacities/{capacityId}/Workloads	Amorphous End-point	 [uppercase found] 
/AssignToCapacity	Amorphous End-point	 [uppercase found] 
/groups/{groupId}/AssignToCapacity	Amorphous End-point	 [uppercase found] 

***Patterns*** 
Count: 27
/admin/tenantKeys	Tidy End-point	
/admin/apps?$top={$top}	Tidy End-point	
/admin/apps/{appId}/users	Tidy End-point	
/admin/dashboards	Tidy End-point	
/admin/groups/{groupId}/dashboards	Tidy End-point	
/admin/dataflows/{dataflowId}/export	Tidy End-point	
/admin/dataflows/{dataflowId}/datasources	Tidy End-point	
/admin/groups/{groupId}/dataflows	Tidy End-point	
/admin/dataflows/{dataflowId}/users	Tidy End-point	
/admin/groups/{groupId}/dataflows/{dataflowId}/upstreamDataflows	Tidy End-point	
/admin/groups/{groupId}/datasets	Tidy End-point	
/admin/groups/{groupId}/datasets/upstreamDataflows	Tidy End-point	
/admin/datasets/{datasetId}/datasources	Tidy End-point	
/admin/capacities	Tidy End-point	
/admin/groups/{groupId}/users	Tidy End-point	
/admin/pipelines/{pipelineId}/users/{identifier}	Tidy End-point	
/admin/workspaces/modified	Tidy End-point	
/admin/workspaces/getInfo	Tidy End-point	
/apps/{appId}	Tidy End-point	
/apps/{appId}/dashboards/{dashboardId}	Tidy End-point	
/apps/{appId}/reports/{reportId}	Tidy End-point	
/apps/{appId}/dashboards/{dashboardId}/tiles/{tileId}	Tidy End-point	
/apps/{appId}/dashboards/{dashboardId}/tiles	Tidy End-point	
/availableFeatures	Tidy End-point	
/capacities	Tidy End-point	
/capacities/{capacityId}/refreshables/{refreshableId}	Tidy End-point	
/groups/{groupId}/dashboards	Tidy End-point	
