***Anti-Pattern*** 
Count: 44
/users/:id/likes/:tweet_id	Amorphous End-point	 [underscore found] 
/tweets/:id/liking_users	Amorphous End-point	 [underscore found] 
/users/:id/liked_tweets	Amorphous End-point	 [underscore found] 
/users/:id/retweets/:source_tweet_id	Amorphous End-point	 [underscore found] 
/tweets/:id/retweeted_by	Amorphous End-point	 [underscore found] 
/users/:source_user_id/blocking/:target_user_id	Amorphous End-point	 [underscore found] 
/users/:source_user_id/following/:target_user_id	Amorphous End-point	 [underscore found] 
/users/:source_user_id/muting/:target_user_id	Amorphous End-point	 [underscore found] 
statuses/home_timeline	Amorphous End-point	 [underscore found] 
statuses/mentions_timeline	Amorphous End-point	 [underscore found] 
statuses/user_timeline	Amorphous End-point	 [underscore found] 
statuses/retweets_of_me	Amorphous End-point	 [underscore found] 
lists/members/create_all	Amorphous End-point	 [underscore found] 
lists/members/destroy_all	Amorphous End-point	 [underscore found] 
friendships/no_retweets/ids	Amorphous End-point	 [underscore found] 
account/verify_credentials	Amorphous End-point	 [underscore found] 
saved_searches/show/:id	Amorphous End-point	 [underscore found] 
account/remove_profile_banner	Amorphous End-point	 [underscore found] 
account/update_profile	Amorphous End-point	 [underscore found] 
account/update_profile_image	Amorphous End-point	 [underscore found] 
saved_searches/create	Amorphous End-point	 [underscore found] 
saved_searches/destroy/:id	Amorphous End-point	 [underscore found] 
custom_profiles/destroy.json	Amorphous End-point	 [underscore found] 
custom_profiles/:id	Amorphous End-point	 [underscore found] 
custom_profiles/list	Amorphous End-point	 [underscore found] 
custom_profiles/new.json	Amorphous End-point	 [underscore found] 
direct_messages/events/destroy	Amorphous End-point	 [underscore found] 
direct_messages/events/list	Amorphous End-point	 [underscore found] 
direct_messages/events/show	Amorphous End-point	 [underscore found] 
direct_messages/welcome_messages/destroy	Amorphous End-point	 [underscore found] 
direct_messages/welcome_messages/rules/destroy	Amorphous End-point	 [underscore found] 
direct_messages/mark_read	Amorphous End-point	 [underscore found] 
direct_messages/indicate_typing	Amorphous End-point	 [underscore found] 
direct_messages/welcome_messages/update	Amorphous End-point	 [underscore found] 
direct_messages/welcome_messages/list	Amorphous End-point	 [underscore found] 
direct_messages/welcome_messages/rules/list	Amorphous End-point	 [underscore found] 
direct_messages/welcome_messages/rules/show	Amorphous End-point	 [underscore found] 
direct_messages/welcome_messages/show	Amorphous End-point	 [underscore found] 
direct_messages/welcome_messages/new	Amorphous End-point	 [underscore found] 
direct_messages/welcome_messages/rules/new	Amorphous End-point	 [underscore found] 
oauth/access_token	Amorphous End-point	 [underscore found] 
oauth/invalidate_token	Amorphous End-point	 [underscore found] 
oauth/request_token	Amorphous End-point	 [underscore found] 
oauth2/invalidate_token	Amorphous End-point	 [underscore found] 

***Patterns*** 
Count: 60
/tweets/search/stream	Tidy End-point	Tidy Endpoint
/tweets/search/stream/rules	Tidy End-point	Tidy Endpoint
/tweets/search/stream/rules	Tidy End-point	Tidy Endpoint
/tweets/:id/hidden	Tidy End-point	Tidy Endpoint
/users/:id/likes	Tidy End-point	Tidy Endpoint
/users/:id/retweets	Tidy End-point	Tidy Endpoint
/tweets/sample/stream	Tidy End-point	Tidy Endpoint
/tweets/search/all	Tidy End-point	Tidy Endpoint
/tweets/search/recent	Tidy End-point	Tidy Endpoint
/users/:id/mentions	Tidy End-point	Tidy Endpoint
/users/:id/tweets	Tidy End-point	Tidy Endpoint
/tweets/counts/all	Tidy End-point	Tidy Endpoint
/tweets/counts/recent	Tidy End-point	Tidy Endpoint
/tweets	Tidy End-point	Tidy Endpoint
/tweets/:id	Tidy End-point	Tidy Endpoint
/users/:id/blocking	Tidy End-point	Tidy Endpoint
/users/:id/blocking	Tidy End-point	Tidy Endpoint
/users/:id/followers	Tidy End-point	Tidy Endpoint
/users/:id/following	Tidy End-point	Tidy Endpoint
/users/:id/following	Tidy End-point	Tidy Endpoint
/users/:id/muting	Tidy End-point	Tidy Endpoint
/users	Tidy End-point	Tidy Endpoint
/users/:id	Tidy End-point	Tidy Endpoint
/users/by	Tidy End-point	Tidy Endpoint
/users/by/username/:username	Tidy End-point	Tidy Endpoint
collections/entries	Tidy End-point	Tidy Endpoint
collections/list	Tidy End-point	Tidy Endpoint
collections/create	Tidy End-point	Tidy Endpoint
collections/entries/add	Tidy End-point	Tidy Endpoint
collections/entries/curate	Tidy End-point	Tidy Endpoint
collections/entries/move	Tidy End-point	Tidy Endpoint
collections/entries/remove	Tidy End-point	Tidy Endpoint
favorites/list	Tidy End-point	Tidy Endpoint
statuses/destroy/:id	Tidy End-point	Tidy Endpoint
statuses/update	Tidy End-point	Tidy Endpoint
lists/list	Tidy End-point	Tidy Endpoint
lists/members	Tidy End-point	Tidy Endpoint
lists/members/show	Tidy End-point	Tidy Endpoint
lists/memberships	Tidy End-point	Tidy Endpoint
lists/ownerships	Tidy End-point	Tidy Endpoint
lists/show	Tidy End-point	Tidy Endpoint
lists/statuses	Tidy End-point	Tidy Endpoint
lists/subscribers/show	Tidy End-point	Tidy Endpoint
lists/subscriptions	Tidy End-point	Tidy Endpoint
lists/create	Tidy End-point	Tidy Endpoint
lists/members/create	Tidy End-point	Tidy Endpoint
lists/members/destroy	Tidy End-point	Tidy Endpoint
lists/subscribers/create	Tidy End-point	Tidy Endpoint
lists/subscribers/destroy	Tidy End-point	Tidy Endpoint
followers/list	Tidy End-point	Tidy Endpoint
friends/list	Tidy End-point	Tidy Endpoint
friendships/incoming	Tidy End-point	Tidy Endpoint
friendships/outgoing	Tidy End-point	Tidy Endpoint
friendships/show	Tidy End-point	Tidy Endpoint
users/search	Tidy End-point	Tidy Endpoint
friendships/create	Tidy End-point	Tidy Endpoint
friendships/destroy	Tidy End-point	Tidy Endpoint
account/settings	Tidy End-point	Tidy Endpoint
account/settings	Tidy End-point	Tidy Endpoint
oauth2/token	Tidy End-point	Tidy Endpoint
