***Anti-Pattern*** 
Count: 47
 /queries/rateLimit 	 Contextless Resource Names
 /queries/sponsorables 	 Contextless Resource Names
 /mutations/abortQueuedMigrations 	 Contextless Resource Names
 /mutations/addDiscussionPollVote 	 Contextless Resource Names
 /mutations/addLabelsToLabelable 	 Contextless Resource Names
 /mutations/addProjectV2ItemById 	 Contextless Resource Names
 /mutations/addStar 	 Contextless Resource Names
 /mutations/addUpvote 	 Contextless Resource Names
 /mutations/cancelSponsorship 	 Contextless Resource Names
 /mutations/clearLabelsFromLabelable 	 Contextless Resource Names
 /mutations/closeIssue 	 Contextless Resource Names
 /mutations/closePullRequest 	 Contextless Resource Names
 /mutations/convertPullRequestToDraft 	 Contextless Resource Names
 /mutations/createRef 	 Contextless Resource Names
 /mutations/createSponsorsTier 	 Contextless Resource Names
 /mutations/deleteRef 	 Contextless Resource Names
 /mutations/dequeuePullRequest 	 Contextless Resource Names
 /mutations/dismissPullRequestReview 	 Contextless Resource Names
 /mutations/enqueuePullRequest 	 Contextless Resource Names
 /mutations/grantEnterpriseOrganizationsMigratorRole 	 Contextless Resource Names
 /mutations/grantMigratorRole 	 Contextless Resource Names
 /mutations/markPullRequestReadyForReview 	 Contextless Resource Names
 /mutations/moveProjectCard 	 Contextless Resource Names
 /mutations/moveProjectColumn 	 Contextless Resource Names
 /mutations/pinIssue 	 Contextless Resource Names
 /mutations/publishSponsorsTier 	 Contextless Resource Names
 /mutations/removeLabelsFromLabelable 	 Contextless Resource Names
 /mutations/removeStar 	 Contextless Resource Names
 /mutations/reopenDiscussion 	 Contextless Resource Names
 /mutations/reopenIssue 	 Contextless Resource Names
 /mutations/reopenPullRequest 	 Contextless Resource Names
 /mutations/rerequestCheckSuite 	 Contextless Resource Names
 /mutations/retireSponsorsTier 	 Contextless Resource Names
 /mutations/revokeEnterpriseOrganizationsMigratorRole 	 Contextless Resource Names
 /mutations/revokeMigratorRole 	 Contextless Resource Names
 /mutations/unarchiveProjectV2Item 	 Contextless Resource Names
 /mutations/unarchiveRepository 	 Contextless Resource Names
 /mutations/unmarkDiscussionCommentAsAnswer 	 Contextless Resource Names
 /mutations/unmarkFileAsViewed 	 Contextless Resource Names
 /mutations/unmarkIssueAsDuplicate 	 Contextless Resource Names
 /mutations/unminimizeComment 	 Contextless Resource Names
 /mutations/unpinIssue 	 Contextless Resource Names
 /mutations/unresolveReviewThread 	 Contextless Resource Names
 /mutations/updateEnterpriseMembersCanMakePurchasesSetting 	 Contextless Resource Names
 /mutations/updatePatreonSponsorability 	 Contextless Resource Names
 /mutations/updateRef 	 Contextless Resource Names
 /mutations/updateRefs 	 Contextless Resource Names

***Patterns*** 
Count: 209
 /queries/codeOfConduct 	 Contextual Resource Names
 /queries/codesOfConduct 	 Contextual Resource Names
 /queries/enterprise 	 Contextual Resource Names
 /queries/enterpriseAdministratorInvitation 	 Contextual Resource Names
 /queries/enterpriseAdministratorInvitationByToken 	 Contextual Resource Names
 /queries/license 	 Contextual Resource Names
 /queries/licenses 	 Contextual Resource Names
 /queries/marketplaceCategories 	 Contextual Resource Names
 /queries/marketplaceCategory 	 Contextual Resource Names
 /queries/marketplaceListing 	 Contextual Resource Names
 /queries/marketplaceListings 	 Contextual Resource Names
 /queries/meta 	 Contextual Resource Names
 /queries/node 	 Contextual Resource Names
 /queries/nodes 	 Contextual Resource Names
 /queries/organization 	 Contextual Resource Names
 /queries/relay 	 Contextual Resource Names
 /queries/repository 	 Contextual Resource Names
 /queries/repositoryOwner 	 Contextual Resource Names
 /queries/resource 	 Contextual Resource Names
 /queries/search 	 Contextual Resource Names
 /queries/securityAdvisories 	 Contextual Resource Names
 /queries/securityAdvisory 	 Contextual Resource Names
 /queries/securityVulnerabilities 	 Contextual Resource Names
 /queries/topic 	 Contextual Resource Names
 /queries/user 	 Contextual Resource Names
 /queries/viewer 	 Contextual Resource Names
 /mutations/abortRepositoryMigration 	 Contextual Resource Names
 /mutations/acceptEnterpriseAdministratorInvitation 	 Contextual Resource Names
 /mutations/acceptTopicSuggestion 	 Contextual Resource Names
 /mutations/addAssigneesToAssignable 	 Contextual Resource Names
 /mutations/addComment 	 Contextual Resource Names
 /mutations/addDiscussionComment 	 Contextual Resource Names
 /mutations/addEnterpriseOrganizationMember 	 Contextual Resource Names
 /mutations/addEnterpriseSupportEntitlement 	 Contextual Resource Names
 /mutations/addProjectCard 	 Contextual Resource Names
 /mutations/addProjectColumn 	 Contextual Resource Names
 /mutations/addProjectV2DraftIssue 	 Contextual Resource Names
 /mutations/addPullRequestReview 	 Contextual Resource Names
 /mutations/addPullRequestReviewComment 	 Contextual Resource Names
 /mutations/addPullRequestReviewThread 	 Contextual Resource Names
 /mutations/addPullRequestReviewThreadReply 	 Contextual Resource Names
 /mutations/addReaction 	 Contextual Resource Names
 /mutations/addVerifiableDomain 	 Contextual Resource Names
 /mutations/approveDeployments 	 Contextual Resource Names
 /mutations/approveVerifiableDomain 	 Contextual Resource Names
 /mutations/archiveProjectV2Item 	 Contextual Resource Names
 /mutations/archiveRepository 	 Contextual Resource Names
 /mutations/cancelEnterpriseAdminInvitation 	 Contextual Resource Names
 /mutations/changeUserStatus 	 Contextual Resource Names
 /mutations/clearProjectV2ItemFieldValue 	 Contextual Resource Names
 /mutations/cloneProject 	 Contextual Resource Names
 /mutations/cloneTemplateRepository 	 Contextual Resource Names
 /mutations/closeDiscussion 	 Contextual Resource Names
 /mutations/convertProjectCardNoteToIssue 	 Contextual Resource Names
 /mutations/copyProjectV2 	 Contextual Resource Names
 /mutations/createAttributionInvitation 	 Contextual Resource Names
 /mutations/createBranchProtectionRule 	 Contextual Resource Names
 /mutations/createCheckRun 	 Contextual Resource Names
 /mutations/createCheckSuite 	 Contextual Resource Names
 /mutations/createCommitOnBranch 	 Contextual Resource Names
 /mutations/createDeployment 	 Contextual Resource Names
 /mutations/createDeploymentStatus 	 Contextual Resource Names
 /mutations/createDiscussion 	 Contextual Resource Names
 /mutations/createEnterpriseOrganization 	 Contextual Resource Names
 /mutations/createEnvironment 	 Contextual Resource Names
 /mutations/createIpAllowListEntry 	 Contextual Resource Names
 /mutations/createIssue 	 Contextual Resource Names
 /mutations/createLabel 	 Contextual Resource Names
 /mutations/createLinkedBranch 	 Contextual Resource Names
 /mutations/createMigrationSource 	 Contextual Resource Names
 /mutations/createProject 	 Contextual Resource Names
 /mutations/createProjectV2 	 Contextual Resource Names
 /mutations/createProjectV2Field 	 Contextual Resource Names
 /mutations/createPullRequest 	 Contextual Resource Names
 /mutations/createRepository 	 Contextual Resource Names
 /mutations/createRepositoryRuleset 	 Contextual Resource Names
 /mutations/createSponsorsListing 	 Contextual Resource Names
 /mutations/createSponsorship 	 Contextual Resource Names
 /mutations/createSponsorships 	 Contextual Resource Names
 /mutations/createTeamDiscussion 	 Contextual Resource Names
 /mutations/createTeamDiscussionComment 	 Contextual Resource Names
 /mutations/declineTopicSuggestion 	 Contextual Resource Names
 /mutations/deleteBranchProtectionRule 	 Contextual Resource Names
 /mutations/deleteDeployment 	 Contextual Resource Names
 /mutations/deleteDiscussion 	 Contextual Resource Names
 /mutations/deleteDiscussionComment 	 Contextual Resource Names
 /mutations/deleteEnvironment 	 Contextual Resource Names
 /mutations/deleteIpAllowListEntry 	 Contextual Resource Names
 /mutations/deleteIssue 	 Contextual Resource Names
 /mutations/deleteIssueComment 	 Contextual Resource Names
 /mutations/deleteLabel 	 Contextual Resource Names
 /mutations/deleteLinkedBranch 	 Contextual Resource Names
 /mutations/deletePackageVersion 	 Contextual Resource Names
 /mutations/deleteProject 	 Contextual Resource Names
 /mutations/deleteProjectCard 	 Contextual Resource Names
 /mutations/deleteProjectColumn 	 Contextual Resource Names
 /mutations/deleteProjectV2 	 Contextual Resource Names
 /mutations/deleteProjectV2Field 	 Contextual Resource Names
 /mutations/deleteProjectV2Item 	 Contextual Resource Names
 /mutations/deleteProjectV2Workflow 	 Contextual Resource Names
 /mutations/deletePullRequestReview 	 Contextual Resource Names
 /mutations/deletePullRequestReviewComment 	 Contextual Resource Names
 /mutations/deleteRepositoryRuleset 	 Contextual Resource Names
 /mutations/deleteTeamDiscussion 	 Contextual Resource Names
 /mutations/deleteTeamDiscussionComment 	 Contextual Resource Names
 /mutations/deleteVerifiableDomain 	 Contextual Resource Names
 /mutations/disablePullRequestAutoMerge 	 Contextual Resource Names
 /mutations/dismissRepositoryVulnerabilityAlert 	 Contextual Resource Names
 /mutations/enablePullRequestAutoMerge 	 Contextual Resource Names
 /mutations/followOrganization 	 Contextual Resource Names
 /mutations/followUser 	 Contextual Resource Names
 /mutations/importProject 	 Contextual Resource Names
 /mutations/inviteEnterpriseAdmin 	 Contextual Resource Names
 /mutations/linkProjectV2ToRepository 	 Contextual Resource Names
 /mutations/linkProjectV2ToTeam 	 Contextual Resource Names
 /mutations/linkRepositoryToProject 	 Contextual Resource Names
 /mutations/lockLockable 	 Contextual Resource Names
 /mutations/markDiscussionCommentAsAnswer 	 Contextual Resource Names
 /mutations/markFileAsViewed 	 Contextual Resource Names
 /mutations/markProjectV2AsTemplate 	 Contextual Resource Names
 /mutations/mergeBranch 	 Contextual Resource Names
 /mutations/mergePullRequest 	 Contextual Resource Names
 /mutations/minimizeComment 	 Contextual Resource Names
 /mutations/regenerateEnterpriseIdentityProviderRecoveryCodes 	 Contextual Resource Names
 /mutations/regenerateVerifiableDomainToken 	 Contextual Resource Names
 /mutations/rejectDeployments 	 Contextual Resource Names
 /mutations/removeAssigneesFromAssignable 	 Contextual Resource Names
 /mutations/removeEnterpriseAdmin 	 Contextual Resource Names
 /mutations/removeEnterpriseIdentityProvider 	 Contextual Resource Names
 /mutations/removeEnterpriseMember 	 Contextual Resource Names
 /mutations/removeEnterpriseOrganization 	 Contextual Resource Names
 /mutations/removeEnterpriseSupportEntitlement 	 Contextual Resource Names
 /mutations/removeOutsideCollaborator 	 Contextual Resource Names
 /mutations/removeReaction 	 Contextual Resource Names
 /mutations/removeUpvote 	 Contextual Resource Names
 /mutations/requestReviews 	 Contextual Resource Names
 /mutations/resolveReviewThread 	 Contextual Resource Names
 /mutations/revertPullRequest 	 Contextual Resource Names
 /mutations/setEnterpriseIdentityProvider 	 Contextual Resource Names
 /mutations/setOrganizationInteractionLimit 	 Contextual Resource Names
 /mutations/setRepositoryInteractionLimit 	 Contextual Resource Names
 /mutations/setUserInteractionLimit 	 Contextual Resource Names
 /mutations/startOrganizationMigration 	 Contextual Resource Names
 /mutations/startRepositoryMigration 	 Contextual Resource Names
 /mutations/submitPullRequestReview 	 Contextual Resource Names
 /mutations/transferEnterpriseOrganization 	 Contextual Resource Names
 /mutations/transferIssue 	 Contextual Resource Names
 /mutations/unfollowOrganization 	 Contextual Resource Names
 /mutations/unfollowUser 	 Contextual Resource Names
 /mutations/unlinkProjectV2FromRepository 	 Contextual Resource Names
 /mutations/unlinkProjectV2FromTeam 	 Contextual Resource Names
 /mutations/unlinkRepositoryFromProject 	 Contextual Resource Names
 /mutations/unlockLockable 	 Contextual Resource Names
 /mutations/unmarkProjectV2AsTemplate 	 Contextual Resource Names
 /mutations/unsubscribeFromNotifications 	 Contextual Resource Names
 /mutations/updateBranchProtectionRule 	 Contextual Resource Names
 /mutations/updateCheckRun 	 Contextual Resource Names
 /mutations/updateCheckSuitePreferences 	 Contextual Resource Names
 /mutations/updateDiscussion 	 Contextual Resource Names
 /mutations/updateDiscussionComment 	 Contextual Resource Names
 /mutations/updateEnterpriseAdministratorRole 	 Contextual Resource Names
 /mutations/updateEnterpriseAllowPrivateRepositoryForkingSetting 	 Contextual Resource Names
 /mutations/updateEnterpriseDefaultRepositoryPermissionSetting 	 Contextual Resource Names
 /mutations/updateEnterpriseMembersCanChangeRepositoryVisibilitySetting 	 Contextual Resource Names
 /mutations/updateEnterpriseMembersCanCreateRepositoriesSetting 	 Contextual Resource Names
 /mutations/updateEnterpriseMembersCanDeleteIssuesSetting 	 Contextual Resource Names
 /mutations/updateEnterpriseMembersCanDeleteRepositoriesSetting 	 Contextual Resource Names
 /mutations/updateEnterpriseMembersCanInviteCollaboratorsSetting 	 Contextual Resource Names
 /mutations/updateEnterpriseMembersCanUpdateProtectedBranchesSetting 	 Contextual Resource Names
 /mutations/updateEnterpriseMembersCanViewDependencyInsightsSetting 	 Contextual Resource Names
 /mutations/updateEnterpriseOrganizationProjectsSetting 	 Contextual Resource Names
 /mutations/updateEnterpriseOwnerOrganizationRole 	 Contextual Resource Names
 /mutations/updateEnterpriseProfile 	 Contextual Resource Names
 /mutations/updateEnterpriseRepositoryProjectsSetting 	 Contextual Resource Names
 /mutations/updateEnterpriseTeamDiscussionsSetting 	 Contextual Resource Names
 /mutations/updateEnterpriseTwoFactorAuthenticationRequiredSetting 	 Contextual Resource Names
 /mutations/updateEnvironment 	 Contextual Resource Names
 /mutations/updateIpAllowListEnabledSetting 	 Contextual Resource Names
 /mutations/updateIpAllowListEntry 	 Contextual Resource Names
 /mutations/updateIpAllowListForInstalledAppsEnabledSetting 	 Contextual Resource Names
 /mutations/updateIssue 	 Contextual Resource Names
 /mutations/updateIssueComment 	 Contextual Resource Names
 /mutations/updateLabel 	 Contextual Resource Names
 /mutations/updateNotificationRestrictionSetting 	 Contextual Resource Names
 /mutations/updateOrganizationAllowPrivateRepositoryForkingSetting 	 Contextual Resource Names
 /mutations/updateOrganizationWebCommitSignoffSetting 	 Contextual Resource Names
 /mutations/updateProject 	 Contextual Resource Names
 /mutations/updateProjectCard 	 Contextual Resource Names
 /mutations/updateProjectColumn 	 Contextual Resource Names
 /mutations/updateProjectV2 	 Contextual Resource Names
 /mutations/updateProjectV2Collaborators 	 Contextual Resource Names
 /mutations/updateProjectV2DraftIssue 	 Contextual Resource Names
 /mutations/updateProjectV2ItemFieldValue 	 Contextual Resource Names
 /mutations/updateProjectV2ItemPosition 	 Contextual Resource Names
 /mutations/updatePullRequest 	 Contextual Resource Names
 /mutations/updatePullRequestBranch 	 Contextual Resource Names
 /mutations/updatePullRequestReview 	 Contextual Resource Names
 /mutations/updatePullRequestReviewComment 	 Contextual Resource Names
 /mutations/updateRepository 	 Contextual Resource Names
 /mutations/updateRepositoryRuleset 	 Contextual Resource Names
 /mutations/updateRepositoryWebCommitSignoffSetting 	 Contextual Resource Names
 /mutations/updateSponsorshipPreferences 	 Contextual Resource Names
 /mutations/updateSubscription 	 Contextual Resource Names
 /mutations/updateTeamDiscussion 	 Contextual Resource Names
 /mutations/updateTeamDiscussionComment 	 Contextual Resource Names
 /mutations/updateTeamReviewAssignment 	 Contextual Resource Names
 /mutations/updateTeamsRepository 	 Contextual Resource Names
 /mutations/updateTopics 	 Contextual Resource Names
 /mutations/verifyVerifiableDomain 	 Contextual Resource Names
