***Anti-Pattern*** 
Count: 9
-/{ig-comment-id}?fields={fields}	Non-pertinent Documentation	Get fields and edges on an IG Comment.
-/{app-id}|{client-token}	Non-pertinent Documentation	Client tokens make Graph API requests on behalf of apps instead of users.
-/{api-version}/{ig-comment-id}	Non-pertinent Documentation	Get Instagram comments
-/{api-version}/{ig-comment-id}/replies	Non-pertinent Documentation	Get a list of IG Comments on the IG Comment; Create an IG Comment on an IG Comment.
-/{ig-comment-id}/replies	Non-pertinent Documentation	Returns a list of IG Comments on an IG Comment.
-/{api-version}/{instagram-container-id}?fields={fields}&access_token={access-token}	Non-pertinent Documentation	Get fields and edges on an IG Container.
-/{api-version}/{ig-hashtag-id}?fields={fields}&access_token={access-token}	Non-pertinent Documentation	Returns Fields and Edges on an IG Hashtag.
-/{api-version}/{ig-media-id}?fields={fields}&access_token={access-token}	Non-pertinent Documentation	Gets fields and edges on IG media.
-v9.0/{ig-user-id}/content_publishing_limit?fields={fields}&since={since}&access_token={access-token}	Non-pertinent Documentation	Get the number of times an IG User has published and IG Container within a given time period. Refer to the Content Publishing guide for complete publishing steps.

***Patterns*** 
Count: 9
-/oauth/access_token	Pertinent Documentation	To generate an app access token, you need
-/{user-id}/accounts?access_token={user-access-token}	Pertinent Documentation	Page access tokens are used in Graph API calls to manage Pages. To generate a page access token, an admin of the page must grant your app the Page permission or permissions needed. Once granted, you can retrieve the Page access token using a user access token with the required permissions.
-/{ig-comment-id}/replies?message={message}	Pertinent Documentation	Replying to a Comment
-/{ig-media-id}/comments	Pertinent Documentation	Create an IG Comment on an IG Media object
-/{ig-comment-id}	Pertinent Documentation	Deleting a Comment
-{api-version}/{ig-media-id}?comment_enabled={comment-enabled} &access_token={access-token}	Pertinent Documentation	Enable or disable comments on an IG Media.
-/{api-version}/{ig-user-id}	Pertinent Documentation	Get fields and edges on an Instagram Business or Creator Account.
-/{api-version}/{ig-user-id}?fields=business_discovery.username({username})	Pertinent Documentation	Returns data about another Instagram Business or Creator IG User. Perform this request on the Instagram Business or Creator IG User who is making the query, and identify the targeted business with the username parameter.
-{api-version}/{ig-user-id}/insights ?metric={metric} &period={period} &since={since} &until={until} &access_token={access-token}	Pertinent Documentation	Returns insights on an IG User.
