***Anti-Pattern*** 
Count: 73
/createCard	CRUDy End-point	 [create found] 
/createCardRelation	CRUDy End-point	 [create found] 
/createComment	CRUDy End-point	 [create found] 
/createFieldCondition	CRUDy End-point	 [create found] 
/createInboxEmail	CRUDy End-point	 [create found] 
/createLabel	CRUDy End-point	 [create found] 
/createOrganization	CRUDy End-point	 [create found] 
/createOrganizationWebhook	CRUDy End-point	 [create found] 
/createPhase	CRUDy End-point	 [create found] 
/createPhaseField	CRUDy End-point	 [create found] 
/createPipe	CRUDy End-point	 [create found] 
/createPipeRelation	CRUDy End-point	 [create found] 
/createPresignedUrl	CRUDy End-point	 [create found] 
/createPresignedUrlForPipePdfTemplate	CRUDy End-point	 [create found] 
/createTable	CRUDy End-point	 [create found] 
/createTableField	CRUDy End-point	 [create found] 
/createTableRecord	CRUDy End-point	 [create found] 
/createTableRecordInRestrictedTable	CRUDy End-point	 [create found] 
/createTableRelation	CRUDy End-point	 [create found] 
/createWebhook	CRUDy End-point	 [create found] 
/deleteCard	CRUDy End-point	 [delete found] 
/deleteComment	CRUDy End-point	 [delete found] 
/deleteFieldCondition	CRUDy End-point	 [delete found] 
/deleteInboxEmail	CRUDy End-point	 [delete found] 
/deleteLabel	CRUDy End-point	 [delete found] 
/deleteOrganization	CRUDy End-point	 [delete found] 
/deleteOrganizationWebhook	CRUDy End-point	 [delete found] 
/deletePhase	CRUDy End-point	 [delete found] 
/deletePhaseField	CRUDy End-point	 [delete found] 
/deletePipe	CRUDy End-point	 [delete found] 
/deletePipeRelation	CRUDy End-point	 [delete found] 
/deleteTable	CRUDy End-point	 [delete found] 
/deleteTableField	CRUDy End-point	 [delete found] 
/deleteTableRecord	CRUDy End-point	 [delete found] 
/deleteTableRelation	CRUDy End-point	 [delete found] 
/deleteWebhook	CRUDy End-point	 [delete found] 
/createTableRelation	CRUDy End-point	 [create found] 
/createWebhook	CRUDy End-point	 [create found] 
/deleteCard	CRUDy End-point	 [delete found] 
/deleteComment	CRUDy End-point	 [delete found] 
/deleteFieldCondition	CRUDy End-point	 [delete found] 
/deleteInboxEmail	CRUDy End-point	 [delete found] 
/deleteInboxEmail	CRUDy End-point	 [delete found] 
/deleteOrganization	CRUDy End-point	 [delete found] 
/deleteOrganizationWebhook	CRUDy End-point	 [delete found] 
/deletePhase	CRUDy End-point	 [delete found] 
/deletePhaseField	CRUDy End-point	 [delete found] 
/deletePipe	CRUDy End-point	 [delete found] 
/deletePipeRelation	CRUDy End-point	 [delete found] 
/deleteTable	CRUDy End-point	 [delete found] 
/deleteTableField	CRUDy End-point	 [delete found] 
/deleteTableRecord	CRUDy End-point	 [delete found] 
/deleteTableRelation	CRUDy End-point	 [delete found] 
/deleteWebhook	CRUDy End-point	 [delete found] 
/moveCardToPhase	CRUDy End-point	 [move found] 
/removeUserFromOrg	CRUDy End-point	 [remove found] 
/removeUserFromPipe	CRUDy End-point	 [remove found] 
/removeUserFromTable	CRUDy End-point	 [remove found] 
/updateCard	CRUDy End-point	 [update found] 
/updateCardField	CRUDy End-point	 [update found] 
/updateComment	CRUDy End-point	 [update found] 
/updateFieldsValues	CRUDy End-point	 [update found] 
/updateLabel	CRUDy End-point	 [update found] 
/updateOrganization	CRUDy End-point	 [update found] 
/updateOrganizationWebhook	CRUDy End-point	 [update found] 
/updatePhase	CRUDy End-point	 [update found] 
/updatePhaseField	CRUDy End-point	 [update found] 
/updatePipe	CRUDy End-point	 [update found] 
/updatePipeRelation	CRUDy End-point	 [update found] 
/updateTable	CRUDy End-point	 [update found] 
/updateTableField	CRUDy End-point	 [update found] 
/updateTableRecord	CRUDy End-point	 [update found] 
/updateWebhook	CRUDy End-point	 [update found] 

***Patterns*** 
Count: 36
/allCards	Verbless End-point	
/autoFillFields	Verbless End-point	
/card	Verbless End-point	
/cards	Verbless End-point	
/cardsImportations/{pipeId}	Verbless End-point	
/findCards/{pipeId}	Verbless End-point	
/findCards/{tableId}	Verbless End-point	
/inbox_emails/card_id	Verbless End-point	
/me	Verbless End-point	
/organization/{id}	Verbless End-point	
/organizations/{ids}	Verbless End-point	
/phase/{id}	Verbless End-point	
/pipe/{id}	Verbless End-point	
/pipeReportExport/{id}	Verbless End-point	
/pipe/{ids}	Verbless End-point	
/pipe_relations/{id}	Verbless End-point	
/pipe_templates	Verbless End-point	
/recordsImportations/{tableID}	Verbless End-point	
/table/{id}	Verbless End-point	
/table/{ids}	Verbless End-point	
/table_record/{id}	Verbless End-point	
/table_records/{table_id}	Verbless End-point	
/table_relations/{ids}	Verbless End-point	
/clonePipes	Verbless End-point	
/exportPipeReport	Verbless End-point	
/exportPipeReport	Verbless End-point	
/interfaceEmbedCreat	Verbless End-point	
/inviteMembers	Verbless End-point	
/recordsImporter	Verbless End-point	
/sendInboxEmail	Verbless End-point	
/setFieldConditionOrder	Verbless End-point	
/setRole	Verbless End-point	
/setRoles	Verbless End-point	
/setSummaryAttributes	Verbless End-point	
/setTableFieldOrder	Verbless End-point	
/setTableRecordFieldValue	Verbless End-point	
