***Anti-Pattern*** 
Count: 4
-/v2/results/	Non-pertinent Documentation	A list of named API resources.  n/a
-/v2/berry/{id}/	Non-pertinent Documentation	The identifier for this resource. n/a
-/v2/berry-firmness/{id}/	Non-pertinent Documentation	The identifier for this resource. n/a
-/v2/berry-firmness/{names}/	Non-pertinent Documentation	The name of this resource listed in different languages. n/a

***Patterns*** 
Count: 20
-/v2/count/	Pertinent Documentation	The total number of resources available from this API.  n/a
-/v2/next/	Pertinent Documentation	The URL for the next page in the list.  n/a
-/v2/previous/	Pertinent Documentation	The URL for the previous page in the list.  n/a
-/v2/berry/{id or name}/	Pertinent Documentation	Berries are small fruits that can provide HP and status condition restoration, stat enhancement, and even damage negation when eaten by PokÃ©mon. n/a
-/v2/berry/{name}/	Pertinent Documentation	The name for this resource. n/a
-/v2/berry/{growth_time}/	Pertinent Documentation	Time it takes the tree to grow one stage, in hours. Berry trees go through four of these growth stages before they can be picked. n/a
-/v2/berry/{max_harvest}/	Pertinent Documentation	The maximum number of these berries that can grow on one tree in Generation IV. n/a
-/v2/berry/{natural_gift_power}/	Pertinent Documentation	The power of the move "Natural Gift" when used with this Berry. n/a
-/v2/berry/{size}/	Pertinent Documentation	The size of this Berry, in millimeters. n/a
-/v2/berry/{smoothness}/	Pertinent Documentation	The smoothness of this Berry, used in making PokÃ©blocks or Poffins. n/a
-/v2/berry/{soil_dryness}/	Pertinent Documentation	The speed at which this Berry dries out the soil as it grows. A higher rate means the soil dries more quickly. n/a
-/v2/berry/{firmness}/	Pertinent Documentation	The firmness of this berry, used in making PokÃ©blocks or Poffins. n/a
-/v2/berry/{flavors}/	Pertinent Documentation	A list of references to each flavor a berry can have and the potency of each of those flavors in regard to this berry. n/a
-/v2/berry/{items}/	Pertinent Documentation	Berries are actually items. This is a reference to the item specific data for this berry. n/a
-/v2/berry/{natural_gift_type}/	Pertinent Documentation	The type inherited by "Natural Gift" when used with this Berry. n/a
-/v2/berry/{potency}/	Pertinent Documentation	How powerful the referenced flavor is for this berry. n/a
-/v2/berry-firmness/{id or name}/	Pertinent Documentation	 n/a
-/v2/berry-firmness/{name}/	Pertinent Documentation	The name for this resource. n/a
-/v2/berry-firmness/{berries}/	Pertinent Documentation	A list of the berries with this firmness. n/a
-v2/berry-flavor/{id or name}/	Pertinent Documentation	Flavors determine whether a PokÃ©mon will benefit or suffer from eating a berry based on their nature. n/a
