***Anti-Pattern*** 
Count: 4
/file_properties/properties/search/continue	CRUDy End-point	 [search found] 
/file_properties/properties/update	CRUDy End-point	 [update found] 
/file_requests/create	CRUDy End-point	 [create found] 
/file_requests/delete	CRUDy End-point	 [delete found] 

***Patterns*** 
Count: 28
/account/set_profile_photo	Verbless End-point	
/auth/token/from_oauth1	Verbless End-point	
/auth/token/revoke	Verbless End-point	
/check/app	Verbless End-point	
/check/user	Verbless End-point	
/contacts/delete_manual_contacts	Verbless End-point	
/contacts/delete_manual_contacts_batch	Verbless End-point	
/file_properties/properties/add	Verbless End-point	
/file_properties/properties/overwrite	Verbless End-point	
/file_properties/templates/remove_for_user	Verbless End-point	
/file_properties/templates/update_for_user	Verbless End-point	
/file_requests/count	Verbless End-point	
/file_requests/delete_all_closed	Verbless End-point	
/file_requests/list/continue	Verbless End-point	
/files/copy_batch/check_v2	Verbless End-point	
/files/copy_batch_v2	Verbless End-point	
/files/copy_reference/get	Verbless End-point	
/files/copy_reference/save	Verbless End-point	
/files/create_folder_batch	Verbless End-point	
/files/create_folder_batch/check	Verbless End-point	
/files/delete_batch/check	Verbless End-point	
/files/download_zip	Verbless End-point	
/files/get_file_lock_batch	Verbless End-point	
/files/get_temporary_upload_link	Verbless End-point	
/files/list_folder/get_latest_cursor	Verbless End-point	
/files/move_batch/check_v2	Verbless End-point	
/files/save_url/check_job_status	Verbless End-point	
/files/upload_session/append_v2	Verbless End-point	
